................................................................................
................................................................................
................................................................................
................................................................................
..................................K.............................................
...............====..........H=======H..........................................
.............====.==........H=.......=H.........................................
...........===.===.==......H=.==...==.=H........................................
...........====.=..=......HH.====.====.=H.......................................
..........==.===.===...H=======..=..=.=.==H.....................................
..........=...=.===...H===...==.H=H.==..===H....................................
..........=....H.....H====...=========..===H....................................
.........=....H=======...=======...======..==H..................................
.........=...H=.........===..=========..==...==H................................
.........=...H..........==...H...H...H...=.....=H...............................
..........=..H..........==H.HHH.HHH.HHH.H=......==H.............................
...........==H...........=...H...H...H..=.........=H............................
.............=H...........====.......===...........=H...........................
..............==H............=========.......=....=.H...........................
................==H.........................=......=H...........................
..................=H.....................===.......=H...........................
...................=H.....=.=.=....=====..........=.H...........................
....................=H.=...=====..===.=..........=..H...........................
....................=H..=.======..====........===...H...........................
.....................H..=.==.===..===.=......=......H...........................
....................=H.=..=====.==.======.....==....H...........................
...................=.H..=......====.====........==..H...........................
..................=..H......=========.............=.H...........................
.................=...H.....==...=..=.==...........=.H...........................
................=....H........H...................=.H...........................
................=....===================H.........=.H...........................
................=............=..........====H......HH...........................
.................=..........=...............=H....H===..........................
.................=.........=.................=HH===.===.........................
...............====....==.=..................==H=======.........................
..............=.==.=====.==.............H......H................................
.............=.===========............M.H......H................................
--------------------------------------------------------------------------------
................................................................................