................................................................................
................................................................................
.........................................................................K......
....................................................................-H------H...
.....................................................................H......H...
.....................................................................H......H...
.....................................................................H......H...
..............................................................-H---------H---...
...............................................................H.........H......
...............................................................H.........H......
...............................................................H.........H......
............................................................--------H------.....
....................................................................H...........
....................................................................H...........
....................................................................H...........
......-H-------------------H----------------------H----------------------H-.....
.......H...................H......................H......................H......
.......H...................H......................H......................H......
.......H...................H......................H......................H......
.......H...................H......................H......................H......
......-----------H---------------------------------------------H-----------.....
.................H.............................................H................
.................H.............................................H................
.................H.............................................H................
.................H.............................................H................
...............------------------H--------------H----------------...............
.................................H..............H...............................
.................................H..............H...............................
.................................H..............H...............................
.................................H..............H...............................
................................---------H--------..............................
.........................................H......................................
.........................................H......................................
.........................................H......................................
.........................................H......................................
..........................H..............H......................................
......M...................H..............H......................................
--------------------------------------------------------------------------------
................................................................................